0000000000000000000000000000000000000000000000000000000000000000F0000000000000000000000000000000000000000000001555520000000000000000000F00000000000000000FFFFFFFFFFFFFFFFFFFFF
0000000000000000000000000000000000000000000000000000000000000000F0000000000000000000000000000000000000000000006999970000000000000000000F00000000000000000FFFFFFFFFFFFFFFFFFFFF
0000000000000000000000000000000000000000000000000000000000000000F00000000000000000000000000BB000000000000000006999970000000000000000000F00000000000000000FFFFFFFFFFFFFFFFFFFFF
0000000000000000000000000000000000000000000000000155555E00C5555520000000000000000000000000000000000000000000006999970000000000000000000F00000000000000000FFFFFFFFFFFFFFFFFFFFF
0000000000000000000000000000000000000000000000BB06000000000000007000000000000000000000BB00000000000000000000006999970000000000000000000F00000000000000000FFFFFFFFFFFFFFFFFFFFF
0000000000000000000000000000000000000000BB000000060000000000000070000000000000000000000000000000000000000000006999970000000000000000000F00000000000000000FFFFFFFFFFFFFFFFFFFFF
00000000000000000000000000000000000000000000000006CDDDDDDDDDDE00700000000000000000BB00000000000000000000000000699997000BBB0000012000155200000000000000000FFFFFFFFFFFFFFFFFFFFF
000000000000000000000000000000000000000000000000060000000000000070000000000000000000000000000000000000000000006999970000000000067000388400000000000000000FFFFFFFFFFFFFFFFFFFFF
00000000000000000000000000000000000000000000BB00060000000000000070000000000000BB0000000000000000000000000000006999970000000000067000670000000000000000000FFFFFFFFFFFFFFFFFFFFF
0000000000000000000000000000000000000000000000000600CDDDDDDDDDDDE000000000000000000000000000000000000000000000388884BB00000000067000670000000000000000000FFFFFFFFFFFFFFFFFFFFF
0000000000000A00000000000000000000000BB00000000006000000000000000000000000BB0000000000000000000000000000000000CDDDDE00000000000670006700000000000000000HIIIIIIIIIIIIIIIIIIIIIJ
000000000000000000000000000000000000000000000000060000000000000000000000000000000000000000000000000000000000000000000000000000067000000000000000000000000000000000000000000000
15555200000000000000015555555555520000000000000006555555555555555555520000000000000000000000000000000000000000C15520000BB00000067000000000000000000000000000000000000000000000
6999970000000000000003888888888884000000000000000699999999999999999997000000000000000000000000000CDDDDDDDDE00006997000000000000671555555555555555552000HIIIIIIIIIIIIIIIIIIIIIJ
388884000000000000000000000000000000000000000000038888888888888888888400000000000000000000000000000000000000000388400000000000034388888888888888888400000000000000000000000000